R 1600 1200
NO ./textures/tile077.xpm
SO ./textures/tile164.xpm
WE ./textures/tile243.xpm
EA ./textures/tile246.xpm
S ./textures/scuanchy.xpm
F 26,22,12
C 88,5,14
     11111111
 111 10000011
 121110000011
 1000000N0011
 111111010011
1111111111111
