R 1500 1200
NO ./textures/tile077.xpm
SO ./textures/tile164.xpm
WE ./textures/tile243.xpm
EA ./textures/tile246.xpm
S ./textures/scuanchy.xpm
F 26,22,22
C 88,5,5
     111 
 111 101 
 1011100 
 100N001 
 1111110 
 111 111 