R 20 20
NO ./textures/wallbrick.xpm
SO ./textures/stone.xpm
WE ./textures/wood.xpm
EA ./textures/wallbrick.xpm
S ./textures/scuanchy.xpm
FT ./textures/floortexture.xpm
F 220,100,0
C 0,0,0
1 1 1 1 1 1 1 1 1
1 0 0 0 0 0 0 0 1
1 0 0 0 0 0 0 0 1
1 0 0 0 1 0 0 0 1
1 0 0 0 0 0 0 0 1
1 0 0 0 1 0 0 0 1
1 0 0 0 0 0 0 0 1
1 0 1 0 S 0 1 0 1
1 0 0 0 0 0 0 0 1
1 0 0 0 1 0 0 0 1
1 1 1 1 1 1 1 1 1